W,W,W,W,W,W,W,W,W,W,W,W,W,W,W,
W,_,_,_,_,_,_,_,_,_,_,_,_,_,W,
W,_,_,_,H,_,_,_,_,_,_,_,_,_,W,
W,_,_,_,_,_,_,@,_,_,_,_,_,_,W,
W,_,_,_,_,_,_,_,_,_,_,_,_,_,W,
W,_,_,_,_,_,_,_,_,_,K,_,_,_,W,
W,_,_,_,_,_,B,_,_,_,_,_,_,_,W,
W,w,w,w,w,w,w,w,w,w,w,w,w,w,W,
W,_,_,_,_,_,_,_,_,_,_,_,_,_,W,
W,F,F,F,F,F,F,F,F,F,F,F,F,F,W,
W,_,_,_,_,_,_,_,_,_,_,_,_,_,W,
W,_,_,_,_,_,_,_,_,_,_,_,_,_,W,
W,_,_,_,_,_,_,_,_,G,_,_,_,_,W,
W,_,_,_,_,_,_,_,_,_,_,_,_,_,W,
W,W,W,W,W,W,W,W,W,W,W,W,W,W,W,