W,W,W,W,W,W,W,W,W,W,W,W,W,W,W,
W,_,_,_,_,_,_,_,_,_,_,_,_,_,W,
W,_,_,_,_,_,_,_,#,@,@,@,_,_,W,
W,_,_,_,_,_,+,_,!,#,@,#,_,_,W,
W,_,_,_,_,_,_,_,!,!,_,_,_,_,W,
W,_,_,_,_,_,_,_,_,_,K,_,_,_,W,
W,_,_,_,_,_,B,_,_,_,_,_,_,_,W,
W,w,w,1,w,w,w,w,B,w,w,w,w,w,W,
W,_,w,1,w,_,_,_,F,_,_,_,_,_,W,
W,F,w,F,w,F,F,F,F,F,F,F,F,F,W,
W,_,w,3,w,_,_,_,_,_,_,_,_,_,W,
W,_,w,2,w,_,_,_,_,_,_,w,2,w,W,
W,_,w,3,w,w,w,w,w,w,w,w,2,w,W,
W,_,w,1,3,K,K,K,K,K,K,K,K,w,W,
W,W,W,W,W,W,W,W,W,W,W,W,W,W,W,