W,W,W,W,W,W,W,W,W,W,W,W,W,W,W,
W,_,_,_,_,_,_,_,_,_,_,_,_,_,W,
W,_,_,_,H,_,_,_,_,_,_,_,_,_,W,
W,_,_,_,_,_,_,@,_,_,_,_,_,_,W,
W,_,_,_,_,_,_,_,_,_,_,_,_,_,W,
W,_,_,_,_,_,_,_,_,_,_,_,_,_,W,
W,_,_,_,_,_,B,_,_,_,_,_,_,_,W,
W,_,_,_,_,_,_,_,_,_,_,_,_,_,W,
W,_,_,_,_,_,_,_,_,_,_,_,_,_,W,
W,B,B,B,B,B,B,B,B,B,B,B,B,B,W,
W,_,_,_,_,_,F,_,_,_,_,_,_,_,W,
W,_,_,_,_,_,_,_,_,_,_,_,_,_,W,
W,_,_,_,_,_,_,_,_,_,_,G,_,_,W,
W,_,_,_,_,_,_,_,_,_,_,_,_,_,W,
W,W,W,W,W,W,W,W,W,W,W,W,W,W,W,